16,0,0,0,0,0,0,0,0,0,0,0,0,
11,0,0,0,0,0,0,0,0,0,0,0,0,
11,0,0,0,0,0,0,0,0,0,0,0,0,
11,0,0,0,0,0,0,0,0,0,0,0,0,
11,0,0,0,01,0,0,0,0,0,0,0,0,
11,0,0,0,0,0,0,0,0,0,0,0,0,
11,0,0,0,0,0,0,0,0,0,0,0,04,
11,0,0,0,0,0,0,0,0,0,0,13,04,
11,11,11,11,11,11,11,11,11,11,11,11,04,
